type octile
height 2
width 9
map
.........
@@@@.@@@@
